NO test.png
SO test.png
WE test.png
EA test.png

F 18,53,25
C 153,204,255

111111111111
1        111
1111111 10001
1000001 1011
10S000010001
111111111111
11         1
111111111111
