NO textures/wolfenstein/grey_stone.xpm
SO textures/wolfenstein/purple_stone.xpm
WE textures/wolfenstein/red_brick.xpm
EA textures/wolfenstein/wood.xpm

F 110,100,0
C 225,30,01


111111111111111111111111111111111111
111111111000000000110000000000001111
111111111011000001110000000000001111
111111111001000000000000000000000111
111111111011000100111000000000000111
100000000011000S01110111111111111111
111101111111110111000000100011111111
111101111111110111010100100011111111
110000001111111100000010001111111111
100000000011111100000011000000100011
100000000001111111101010010001111111
110000011101010111110111100111111111
111101111111010111011110100011111111
111111111111111111111111111111111111