NO wsa.png 
SO wsa.png
WE wsa.png
EA wsa.png

F 77,107,83
C 135,206,1


111111111111
110000000001
1S0000000001
111101100001
111111111111