NO textures/wolfenstein/grey_stone.xpm
SO textures/wolfenstein/purple_stone.xpm
WE textures/wolfenstein/red_brick.xpm
EA textures/wolfenstein/wood.xpm

F 110,100,0
C 225,30,01


        111111111111111111111111
        1000000000110000000000001
        1011000001110000000000001
        1001000S000000000000000001
1111111110110001001110000000000001
100000000011000001110111111111111
11110111111111011100000010001
111101111111110111010100100011
11000000111111110000001000111111111
10000000001    10000001100000010001
100000000001111111101010010001111111
11000001110101011111011110011
11110111 1110101 101111010001
11111111 1111111 111111111111