NO wsa.png 
SO wsa.png
WE wsa.png
EA wsa.png

F 77,107,83
C 135,206,1

1111111
11111111
1111111
111111111
10001111
100001N1
11111111
11111111
1111111111
11111111
1111111111
11111111
1111111111
11111111